XXXXXX
X @  X
XXXX X
X    X
Xo # X
XXXXXX