XXXXXX
X  @ X
X#XX X
X    X
Xoo# X
XXXXXX
